111111111111
1CCCCCCCCCC1
1CCCCCCPCCC1
1CCCCCCCCCC1
1CCCCCCCCCC1
1CCCC1CCCCC1
1CCC1C1C1E01
1CCCCCCC1CC1
1CCCCCCC1CC1
111111111111