11111111111111111111
1CCCC1CCCCCCCC1CCCC1
1C11C1C111111C1C1EC1
1C1CCCCCCCCCCCCCC1C1
1C1C11C11GG11C11C1C1
101C11C111111C11C1C1
101CCCCC0P0CCCCCC1C1
1011C1C111111C1C11C1
100001CCCCCCCC1CCCC1
11111111111111111111