1111111111111
1101011000011
1101011111011
1100011000011
1111011011111
1111011000011
1111111111111
11GCPCCCCCE11
1111111111111