11111111111111111111111111
1CCGCCCCCCC1CCCCCCCCCCCCC1
1CCGCCCCCCC1CCCCCCCCCCCCC1
1CCGCCCGCCC1CCCCCCCCCCCCC1
1CCGCCCGCCC1CCCCCCCCCCCCC1
1CCGCGCGCCC1PCCCCCCCCCCCC1
1CCGCGCGCCC1CCCCCCCCCCCCC1
1CCGCGCGCCC1CCCCCCCCCCCCC1
1CCGCGCGCCC1CCCCCCCCCCCCC1
1CCCCCCCCCCCCCCCCCCCCCCCE1
11111111111111111111111111