111111111111
1CCCCCCCCCC1
1CCCCCCCCCC1
1CCCCCCCCCC1
100000000001
1CCCCCCCCCC1
1CGCGCCC1E01
1CCCCCCC1CP1
1CCCCCCC1CC1
111111111111