1111111111111111111111111111
1CCCCGCCCCCCC1CCCCCCCCCCCCC1
1CCCCGCCCCCCC1CCCCCCCCCCCCC1
1CCCCGCCCGCCC1CCCCCCCCCCCCC1
1CCCCGCCCGCCC1CCCCCCCCCCCCC1
1CCCCGCGCGCCC1PCCCCCCCCCCCC1
1CCCCCCCCCCCC1CCCCCCCCCCCCC1
1CCCCCCCCCCCC1CCCCCCCCCCCCC1
1CCCCCCCCCCCC1CCCCCCCCCCCCC1
1C111111111111C11111C1111111
1CCCCCCCCCCCCCCCCCCCCCCCCCE1
1111111111111111111111111111